"a" = (/turf/tile/autotile/water,/area)
"b" = (/turf/tile/dirt,/area)
"c" = (/obj/rock,/turf/tile/dirt,/area)
"d" = (/obj/tree,/turf/tile/dirt,/area)
"e" = (/obj/tree,/turf/tile/grass,/area)
"f" = (/turf/tile/grass,/area)

(1,1,1) = {"
aaaaaaaaaaabbbbbbbbbbbbbbbbbbbbbbbbbbbbbbbbbbbbbbb
aaaaaaaaaaabbbbbbbbbbbbbbbbbbbbbbbbbbbbbbbbbbbbbbb
aaaaaaaaaaaaabbbbbbbbbbbbbbbbbbbbbbbbbbbbbbbbbbbbb
aaaaaaaaaaaaaaaaabbbbbbbbbbbbbbbbbbbbbbbbbbbbbbbbb
aaaaaaaaaaaaaaaaaaabbbbbbbbbbbbbbbbbbbbbbbbbbbbbbb
aaaaaabaaaaaaaaaaaaaabbbbbbbbbbbbbbbbbbbbbbbbbbbbb
aaaabbbbbaaaaaaaaaaaaaabbbbbbbbbbbbbbbbbbbbbbbbbbb
aaabbbbbbbbbbaaaaaaaaaaabbbbbbbbbbbbbbbbbbbbbbbbbb
abbbbbbbbbbbbbbaaaaaaaaabbbbbbbbbbbbbbbbbbbbbbbbbb
bbbbbbbbbbbbbbbbbbaaaaaaaabbbbbbbbbbbbbbbbbbbbbbbb
bbbbbbbbbbbbbbbbbaaaaaaaaaabbbbbbbbbbbbbbbbbbbbbbb
bbbbbcbbbbbbbbbbbbbbaaaaaaabbbbbbbbbbbbbbbbbbbbbbb
bbbbbbbbbbbbbbbbbbbbbaaaaaaabbbbbbbbbbbcbbbbbbbbbb
bbbbbbbbbbbbbbbbbbbbbbaaaaaaabbbbbbbbbbbbbbbbbbbbb
bbbbbbbbbbbbbbbbbbbbbbbbbaaaaaaabbbbbbbbbbbbbbbbbb
bbbbbbbbbbbbbbbbbcbbbbbbaaaaaaaaabbbbbbbbbbbbbbbbb
abbbbbbbbbbbbbbbbbbbbbbbaaaaaaaaabbbbbbbbbbbbbbbbb
aaabbbbbbcbbbbbbbbbbbbaaaaaaaaaaaaaabbbbbbbbbbbbbb
aaaaabbbbbbbbbbbbbbbaaaaaaaaaabbaaaaaabbbbbbbbbbbb
aaaaaaabbbbbbbbbaaaaaaaaaaabbbbbbbaaaabbbbbbbbbbbb
aaaaaaaaaaaaaaaaaaaaabbbbbbbbbbbbbaaaaaabbbbbbbbbb
aaaaaaaaaaaaaaaaaaaabbbbbbbbbbbbbbbbbaaaaaaabbbbaa
aaaaaaaaaaaaaaaaaaaabbbbbbbbbbbbbbbbbbbbbaaaaaaaaa
bbbbbbbbbbbbbbbbbbbbbcbbbcbbbbbbbcbbbbbbbbbbbbbbbb
bbbbbbbbbbbbbbbbbbbbbbbbbbbbbbbbbbbbbbbbbbbbbbbbbb
bcbbbbbbbbbbbbbbbbbbbbbbbbbbbbbbbbbbbbbbbbbbbbbbbb
bbbbbbbbdbbbbbbbbbbbbbbbbbbbbbbbbbbbbbbbbbbbbbbbbb
bbbbbbbbbbbbbbbbbbbbbbbbbbbbbbbbbbbbbbbbbbbbbbbbbb
bbbbbbbbbbbbbbbbbbbbefbbbbbbbbbbfbbbbbbbbbbbfbbfff
fbbbbbfbbbfffbfbbbfffffbbbbbbbbbbbbfffffbbbfbbbbbf
bbbbbbffffbffffffbbbbbbbbbbffbbcfbbbbbbbbbbbfbfffb
ffffffbbffbbbfbfffffffffffffffbbbfffffffffffbbbbbb
fffffffffbbbbbfffffffffffffbffffffffffffffffffffff
ffefffffffffbbbffffbffbffffbbfffffffffffffffffffff
ffffffffffffffffbffffffbfbffffffffbfffffffffffffff
fffffffffffffffbffffffbfbffffeffffbbffffffffffffff
ffffffffffffffffffffffbbbfffffffffffffffffffffffff
ffffffffffffffffffffffffffffffffffffffffffffffffff
ffffffffffffffffffffffffffffffffffffffffffffffffff
ffffffffffffefffffffffffffffffffffffffffffffffffff
ffffffffffffffffffffffffffffbfffffffffffffffffffff
ffffffffffffffffffffffffffffffffffffffffffffffffff
ffffffffffffffffffffffffffffffffffffffffffffffffff
ffffffffffffffffffffffffffffffffffffffffffffffffff
ffffffffffffffffffffffffffffffffffffffffffffffffff
ffffffffffffffffffffffffffffffffffffffffffffffffff
ffffffffffffffffffffffffffffffffffffffffffffffffff
ffffffffffffffffffffffffffffffffffffffffffffffffff
ffffffffffffffffffffffffffffffffffffffffffffffffff
ffffffffffffffffffffffffffffffffffffffffffffffffff
"}
